WWWWWWWWW--WWWWWWWWWWWWWWWWWWWWWWWWW--WWWWWWWWWWWW
WWWWWWWW--WWWWWWWWWWWWWWWWWWWWWWWWW--WWWWWWWWWWWWW
WWWWWWWW------WWWWWWWWWWWWWW---------WWWWWWWWWWWWW
WWWWWWWW------WWWWWWWWWWWWWW---------WWWWWWWW--WWW
WWWWWWWWWWWW--WWWWWWWWWWWWWW--WWWWWWWWWWWWWWW--WWW
WWWWWWWWWWWW--WWWWWWWWWWWWWW--WWWWWWWWWWWWWWW--WWW
WWWWWWWWWWWW--WWWWWWWWWWWWWW--WWWWWWWWWWW------WWW
WWWWWW--------WWWWWWWWWWWWWW--WWWWWWWWW--------WWW
WWWWWW--------WWW-------------WWWW---------WW--WWW
WWW-----WWWWWWWWW-------------WWWW------WWWWW--WWW
WWW-----WWWWWWWWW--WWWWWWWWWWWWWW---WWWWWWWWW--WWW
WWWWWW--WWWWWWWWW--WWWWWWWWWWWWWW---WWWWWWW----WWW
WWWWWW--WWWW-------WWWW--WWW--WWW--WWWWWWWW----WWW
W-------WWWW-------WWWW--WWW--WWW--WWWWWWWW--WWWWW
W-------------WWWWWWW--------------WWWWWWWW--WWWWW
WWWWW---------WWWWWWW--------------WWWWWWWW--WWWWW
WWWWW--WWWWW-------WWWWW--WWW--WWWWWWWWWWW---WWWWW
-------WWWWW-------WWWWW--WWW--WWWWWWWWWW---WWWWWW
----------WWWWWWW--WWWWW---WW--WWWWWWWWWW--WWWWWWW
WWWWWW----WWWWWWW--WWWWW---WW---WWWWWWWWW--WWWWWWW
WWWWWWWW--WWWWWWW-----WWW--WW---WWWWWWWWW---------
WWWWWWWW--WWWWWWW-----WWW--WWW--WWWWWWWWW---------
WWWW------WWWWWWWWWW--WWW--WWW--WWWWWWWWWW--WWWWWW
WWWW------WWWWWWWWWW--WWW--WW---WWWWWWWWWW--WWWWWW
WWWW---WWWWWWWWWWWWW--WWWWWWW--WWWWWWWWWWW--WWWWWW
WWWWW--WWWWWWWWWWWWW--WWWWWWW--WWWWWWW------WWWWWW
WWWWW---WWWWWWWWWWW----WWWWWW--WWWWWWW------WWWWWW
WWWWW---WWWWWW--------------------------WWWWWWWWWW
WWWWWW----------------------------------WWWWWWWWWW
WWWWWWW--------WWWW----WWWWWWWWWWWWWWWWWWWWWWWWWWW
WWWWWWWWWWWWWWWWWWWW--WWWWWWWWWWWWWWWWWWWWWWWWWWWW
WW--WWWWWWWWWWWWWWWW--WWWWWWWWWWW----------WWWWWWW
WW--WWWWWWWWWWWWWWWW--WWWWWW---------------WWWWWWW
WW--WWWWWWWWWWWWWWWW---------------WWWWWW--WWWWWWW
WW--WW---------WWWWW---------WWWWWWWWWWWW--WWWWWWW
WW--WW---------WWWWW--WWWWWWWWWWWWWWWWWWW--WWWWWWW
--------WWWWW--WWWWW--WWWWWWWWWW------------------
--------WWWWW---------WWWWWWWWWW------------------
WWWWWWWWWWWWW---------WWWWWWWWWW--WWWWWWWWWWWWWWWW
WWWWWWWWWWWWW--WWWWWWWWWWWWWWWWW--WWWWWWWWWWWWWWWW
WWWWWWW--------WWWWWWWWWWWWWWWWW--WWWWWWWWWWWWWWWW
WWWWWWW----------------WWWWWWWWW--------WWWWWWWWWW
WWWWWWW--WWWW----------WWWWWWWWW--------WWWWWWWWWW
WWWWWWW--WWWWWWWWWWWW---WWWWWWWWWWWWWW--WWWWWWWWWW
WWW------WWWWWWWWWWWW---WWWWWWWWWWWWWW--WWWWWWWWWW
WWW------WWWWWWWWWWWWW--WWWWWWWWWWWWWW---------WWW
WWW--WWWWWWWWWWWWWWWWW--WWWWWWWWWWWWWW---------WWW
WWW--WWWWWWWWWWWWWWWWW--WWWWWWWWWWWWWWWWWWWWW--WWW
WWW--WWWWWWWWWWWWWWWWW--WWWWWWWWWWWWWWWWWWWWW--WWW
WWW--WWWWWWWWWWWWWWWWW--WWWWWWWWWWWWWWWWWWWWW--WWW