----------------------------------------
----------------------------------------
----------------------------------------
----WWWWWWWWWWWWW------WWWWWWWWWWWWW----
----WWWWWWWWWWWWW------WWWWWWWWWWWWW----
----WW----------------------------WW----
----WW----------------------------WW----
----WW----------------------------WW----
----WW----------------------------WW----
----WW----------------------------WW----
----WW----------------------------WW----
----WW----------------------------WW----
----WW----------------------------WW----
----WW----------------------------WW----
----WW----------------------------WW----
----WW----------------------------WW----
----WW----------------------------WW----
----WW----------------------------WW----
----WW----------------------------WW----
----WW----------------------------WW----
----WW----------------------------WW----
----WW----------------------------WW----
----WW----------------------------WW----
----WW----------------------------WW----
----WW----------------------------WW----
----WW----------------------------WW----
----WW----------------------------WW----
----WW----------------------------WW----
----WW----------------------------WW----
----WW----------------------------WW----
----WW----------------------------WW----
----WW----------------------------WW----
----WW----------------------------WW----
----WW----------------------------WW----
----WWWWWWWWWWWWW------WWWWWWWWWWWWW----
----WWWWWWWWWWWWW------WWWWWWWWWWWWW----
----------------------------------------
----------------------------------------
----------------------------------------