WWWWWWWWWWWWWWWWWWWWWWWWWWWWWWWWWWWWWWWW
--------WWWWWWWWWWWWWWWWWWWWWWWWWWWWWWWW
--------WWWWWWWWWWWWWWWWWWWWWWWWWWWWWWWW
--------WWWWWWWWWWWWWWWWWWWWWWWWWWWWWWWW
--------WWWWWWWWWWWWWWWWWWWWWWWWWWWWWWWW
--------WWWWWWWWWWWWW--------PPP--------
--------WWWWWWWWWWWWW--------PPP--------
--------WWWWWWWWWWWWW--------PPP--------
--------WWWWWWWWWWWWW------WWWWWWW------
--------WWWWWWWWWWWWW------WWWWWWW------
---------------------------WWWWWWW------
---------------------------WWWWWWW------
---------------------------WWWWWWW------
WWWWWWWWWWWWWWWWWWWWWWWWWWWWWWWWWW------
WWWWWWWWWWWWWWWWWWWWWWWWWWWWWWWWWW------
WWWWWWWWWWWWWWWWWWWWWWWWWWWWWWWWWW------
-----------------------------PPP--------
-----------------------------PPP--------
-----------------------------PPP--------
-----WWWWWWWWWWWWWWWWWWWWWWWWWWWWWWWWWWW
-----WWWWWWWWWWWWWWWWWWWWWWWWWWWWWWWWWWW
-----WWWWWWWWWWWWWWWWWWWWWWWWWWWWWWWWWWW
-------PP------------WWWWWWWWWWWWWWWWWWW
-------PP------------WWWWWWWWWWWWWWWWWWW
-------PP------------WWWWWWWWWWWWWWWWWWW
WWWWWWWWWWWWWWWWWW---WWWWWWWWWWWWWWWWWWW
WWWWWWWWWWWWWWWWWW---WWWWWWWWWWWWWWWWWWW
WWWWWWWWWWWWWWWWWW---WWWWWWWWWWWWWWWWWWW
WWWWWWWWWWWWWWWWWW---WWWWWWWWWWWWWWWWWWW
WWWWWWWWWWWWWWPPPPPPPPPPPWWWWWWWWWWWWWWW
WWWWWWWWWWWWWWPPPPPPPPPPPWWWWWWWWWWWWWWW
WWWWWWWWWWWWWWPPPPPPPPPPPWWWWWWWWWWWWWWW
WWWWWWWWWWWWWW-----------WWWWWWWWWWWWWWW
WWWWWWWWWWWWWW-----------WWWWWWWWWWWWWWW
WWWWWWWWWWWWWW-----------WWWWWWWWWWWWWWW
WWWWWWWWWWWWWW-----------WWWWWWWWWWWWWWW
WWWWWWWWWWWWWW-----------WWWWWWWWWWWWWWW
WWWWWWWWWWWWWW-----------WWWWWWWWWWWWWWW
WWWWWWWWWWWWWW-----------WWWWWWWWWWWWWWW
WWWWWWWWWWWWWW-----------WWWWWWWWWWWWWWW