-----WWWW-----------
----WWWW------------
----WWWW------------
--------------------
--------------------
---------WWWWWW-----
---------WWWWWW-----
---------W----W-----
---------W----W-----
---------W----W-----
---------WW--WW-----
---------WW--WW-----
--------------------
--------------------
---WW--WW-----------
---WW--WW-----------
---W----W-----------
---W----W-----------
---W----W-----------
---WWWWWW-----------
---WWWWWW-----------
---WWWWWW-----------