----------------------------
----------------------------
----------------------------
----------------------------
----------------------------
-------PPPPPPPPPPPPP--------
-------PPPPPPPPPPPPP--------
-------PP---------PP--------
-------PP---------PP--------
-------PP---------PP--------
-------PP---------PP--------
-------PP---------PP--------
-------PP---------PP--------
-------PP---------PP--------
-------PPPPPPPPPPPPP--------
-------PPPPPPPPPPPPP--------
----------------------------
----------------------------
----------------------------
----------------------------
----------------------------