PPPPPPPPPPPP------PP
PPPPPPPPPPP------PPP
PPPPPPPPPPP------PPP
PPPPPPPPPPP------PPP
PPPPPPPPPPP------PPP
PPP--------------PPP
PPP--------------PPP
PPP--------------PPP
PPP-----PPPPPPPPPPPP
PPP-----PPPPPPPPPPPP
PPP-----PPPPPPPPPPPP
PPP-----PPPPPPPPPPPP
PPP--------------PPP
PPP--------------PPP
PPP--------------PPP
PPPPPPPPPPP------PPP
PPPPPPPPPPP------PPP
PPPPPPPPPPP------PPP
PPPPPPPPPPP------PPP
PPPPPPPPPPP------PPP