----------------------------------------
----------------------------------------
----------------------------------------
---------WWWWWWWWWWWWWWWWWWWWWW---------
---------WWWWWWWWWWWWWWWWWWWWWWW--------
-----------------------WW-----WW--------
-----------------------WW-----WW--------
---------WWWWWWWWWWWWWWWWWWWWWWW--------
---------WWWWWWWWWWWWWWWWWWWWWW---------
----------------------------------------
----------------------------------------
---------WWWWWWWWWWWWWWWWWWWWWWW--------
---------WWWWWWWWWWWWWWWWWWWWWWW--------
-----------------------WW-----WW--------
-----------------------WW-----WW--------
-----------------------WWWWWWWWW--------
-----------------------WWWWWWWWW--------
----------------------------------------
----------------------------------------
---------WWWWWWWWWWWWWWWWWWWWWW---------
---------WWWWWWWWWWWWWWWWWWWWWWW--------
-----------------------WW-----WW--------
-----------------------WW-----WW--------
---------WWWWWWWWWWWWWWWWWWWWWWW--------
---------WWWWWWWWWWWWWWWWWWWWWW---------
----------------------------------------
----------------------------------------
---------WWWWWWWWWWWWWWWWWWWWWWW--------
---------WWWWWWWWWWWWWWWWWWWWWWW--------
---------WW-------------------WW--------
---------WW-------------------WW--------
---------WW-------------------WW--------
----------------------------------------
----------------------------------------
---------WWWWWWWWWWWWWWWWWWWWWWW--------
---------WWWWWWWWWWWWWWWWWWWWWWW--------
-------------------WW-------------------
-------------------WW-------------------
---------WWWWWWWWWWWWWWWWWWWWWWW--------
---------WWWWWWWWWWWWWWWWWWWWWWW--------
----------------------------------------
----------------------------------------
---------WWWWWWWWWWWWWWWWWWWWWWW--------
---------WWWWWWWWWWWWWWWWWWWWWWW--------
---------WW---------WW--------WW--------
---------WW---------WW--------WW--------
---------WW---------WW--------WW--------
----------------------------------------
----------------------------------------
----------------------------------------