----------------------
---PPPPP------WWWW----
---PPPPP------WWWW----
---PPPPP------WWWW----
----------------------
----------------------
-------WWWWW----------
-------WWWWWW---------
-------WWWWWW---------
----------WW----------
----------------------
----------------------
--WWWWW-------PPPPP---
--WWWWW-------PPPPP---
--WWWWW-------PPPPP---
----------------------
----------------------
----------------------