--------------------
--------------------
--------------------
----------WWWWWWWWWW
----------WWWWWWWWWW
----------WWWWWWWWWW
WWWW---WWWWW--------
WWWW---WWWWW--------
WWWW---WWWWW--------
--------------------
--------------------
WWWW---WWWWW--------
WWWW---WWWWW--------
WWWW---WWWWW--------
----------WWWWWWWWWW
----------WWWWWWWWWW
----------WWWWWWWWWW
--------------------
--------------------
--------------------