--------------------
-------------------W
--WWWWWWWWWWWWWWWWWW
--WWWWWWWWWWWWWWWWWW
--WWWWWWWWWWWWWWWWWW
--WWWWWWWWWWWWWWWWWW
--WWWWWWWWWWWWWWWWWW
--WWWWWWWWWWWWWWWWWW
--WWWWWWWWWWWWWWWWWW
------------WWWWWWWW
------------WWWWWWWW
WWWWWWWWWW--WWWWWWWW
WWWWWWWWWW--WWWWWWWW
WWWWWWWWWW--WWWWWWWW
WWWWWWWWWW--WWWWWWWW
WWWWWWWWWW--WWWWWWWW
------------WWWWWWWW
------------WWWWWWWW