---------------------------WWWWWWWWW------
--------------------------WWWWWWWWW------W
--------------------------WWWWWWWWW------W
--------------------------WWWWWWWWW------W
-----------------------------------------W
-----------------------------------------W
-----------------------------------------W
WWWWWWWW---------------------------------W
WWWWWWWW---------------------------------W
WWWWWWWW---------------------------------W
WWWWWWWW---------------------------------W
WWWWWWWW-------WWWWWWW-------------------W
---------------WWWWWWW-------------------W
---------------WWWWWWW-------------------W
---------------WWWWWWWWWWWWWWWWWWWWWWWWWWW
---------------WWWWWWWWWWWWWWWWWWWWWWWWWWW
----------------------WWWWWWWWWWWWWWWWWWWW
----------------------WWWWWWWWWWWWWWWWWWWW
----------------------WWWWWWWWWWWWWWWWWWWW
----------------------WWWWWWWWWWWWWWWWWWWW
----------------------WWWWWWWWWWWWWWWWWWWW
------------WWWWWWWWWWWWWWWWWWWWWWWWWWWWWW
------------WWWWWWWWWWWWWWWWWWWWWWWWWWWWWW
------------WWWWWWWWWWWWWWWWWWWWWWWWWWWWWW
------------WWWWWWWWWWWWWWWWWWWWWWWWWWWWWW
------------WWWWWWWWWWWWWWWWWWWWWWWWWWWWWW
--------------------WWWWWWWWWWWWWWWWWWWWWW
--------------------WWWWWWWWWWWWWWWWWWWWWW
--------------------WWWWWWWWWWWWWWWWWWWWWW
--------------------WWWWWWWWWWWWWWWWWWWWWW
--------------------WWWWWWWWWWWWWWWWWWWWWW
--------------------WWWWWWWWWWWWWWWWWWWWWW
--------------------WWWWWWWWWWWWWWWWWWWWWW
--------------------WWWWWWWWWWWWWWWWWWWWWW