------------------------
------------------------
------------------------
------------------------
------------------------
WWWWWWWW--WWWWWWWWWWWWWW
WWWWWWWW--WWWWWWWWWWWWWW
WWWWWWWW--WWWWWWWWWWWWWW
WWWWWWWW--WWWWWWWWWWWWWW
WWWWWWWW--------WWWWWWWW
WWWWWWWW--------WWWWWWWW
WWWWWWWWWWWWWW--WWWWWWWW
WWWWWWWWWWWWWW--WWWWWWWW
WWWWWWWWWWWWWW--WWWWWWWW
WWWWWWWWWWWWWW--WWWWWWWW
------------------------
------------------------
------------------------
------------------------
------------------------