----------------------
----------------------
----------------------
----------------------
--------PPPPP---------
--------PPPPP---------
--------PPPPP---------
--------PPPPP---------
-----PPPPPPPP---------
-----PPPPPPPP---------
-----PPPPPPPP---------
--------PPPPP---------
--------PPPPP---------
--------PPPPP---------
--------PPPPP---------
--------PPPPPPPP------
--------PPPPPPPP------
--------PPPPPPPP------
--------PPPPPPPP------
--------PPPPPPPP------
--------PPPPP---------
--------PPPPP---------
--------PPPPP---------
--------PPPPP---------
--------PPPPP---------
--------PPPPP---------
----------------------
----------------------
----------------------
----------------------