----------------------------------------
----------------------------------------
----------------------------------------
----------------------------------------
---WWWW-------------------------WWWWW---
---WWWW-------------------------WWWWW---
---WWWW-------------------------WWWWW---
---WWWW-------------------------WWWWW---
---WWWWWWWWWWWWWWWWWWWWWW-------WWWWW---
---WWWWWWWWWWWWWWWWWWWWWW-------WWWWW---
---WWWWWWWWWWWWWWWWWWWWWW-------WWWWW---
---WWWWWWWWWWWWWWWWWWWWWW-------WWWWW---
---WWWW-------------------------WWWWW---
---WWWW-------------------------WWWWW---
---WWWW-------------------------WWWWW---
---WWWW-------------------------WWWWW---
---WWWW-------------------------WWWWW---
----------------------------------------
--------PPPPPPPPPPPPPPPPPPPPPPP---------
--------PPPPPPPPPPPPPPPPPPPPPPP---------
--------PPPPPPPPPPPPPPPPPPPPPPP---------
----------------------------------------
---WWWW-------------------------WWWWW---
---WWWW-------------------------WWWWW---
---WWWW-------------------------WWWWW---
---WWWW-------------------------WWWWW---
---WWWW-------------------------WWWWW---
---WWWW------WWWWWWWWWWWWWWWWWWWWWWWW---
---WWWW------WWWWWWWWWWWWWWWWWWWWWWWW---
---WWWW------WWWWWWWWWWWWWWWWWWWWWWWW---
---WWWW------WWWWWWWWWWWWWWWWWWWWWWWW---
---WWWW-------------------------WWWWW---
---WWWW-------------------------WWWWW---
---WWWW-------------------------WWWWW---
---WWWW-------------------------WWWWW---
----------------------------------------
----------------------------------------
----------------------------------------
----------------------------------------
----------------------------------------