WWWWWWWWWWWWWWWWWWWWWWWWWWWWWW
WWWWWWWWWWW--------WWWWWWWWWWW
WWWWWWWWWWW--------WWWWWWWWWWW
WWWWWWWWWWW--------WWWWWWWWWWW
WWWWWWWWWWW--------WWWWWWWWWWW
WWWWWWWWWWW--------WWWWWWWWWWW
WWWWWWWWWWW--------WWWWWWWWWWW
WWWWWWWWWWW--------WWWWWWWWWWW
WWWWWWWWWWW--------WWWWWWWWWWW
WWWWWWWWWWW--------WWWWWWWWWWW
WWWWWWWWWWW--------WWWWWWWWWWW
WWWWWWWWWWW--------WWWWWWWWWWW
------------------------------
------------------------------
------------------------------
------------------------------
------------------------------
------------------------------
------------------------------
------------------------------
WWWWWWWWWWW--------WWWWWWWWWWW
WWWWWWWWWWW--------WWWWWWWWWWW
WWWWWWWWWWW--------WWWWWWWWWWW
WWWWWWWWWWW--------WWWWWWWWWWW
WWWWWWWWWWW--------WWWWWWWWWWW
WWWWWWWWWWW--------WWWWWWWWWWW
WWWWWWWWWWW--------WWWWWWWWWWW
WWWWWWWWWWW--------WWWWWWWWWWW
WWWWWWWWWWW--------WWWWWWWWWWW
WWWWWWWWWWW--------WWWWWWWWWWW
WWWWWWWWWWW--------WWWWWWWWWWW