----------------------------------------
----------------------------------------
----------------------------------------
------------------------WWWWWWWWWWW-----
------------------------WWWWWWWWWWW-----
------------------------WWWWWWWWWWW-----
-----------WWWWWWWWWWWWWWWWWWWWWWWW-----
-----------WWWWWWWWWWWWWWWWWWWWWWWW-----
-----------WWWWWWWWWWWWWWWWWWWWWWWW-----
----------------------------------------
----------------------------------------
----------------------------------------
----------------------------------------
-----WWWWWWWWWWWWWWWWWWWWWWWW-----------
-----WWWWWWWWWWWWWWWWWWWWWWWW-----------
-----WWWWWWWWWWWWWWWWWWWWWWWW-----------
-----WWWWWWWWWWW------------------------
-----WWWWWWWWWWW------------------------
-----WWWWWWWWWWW------------------------
----------------------------------------
----------------------------------------
----------------------------------------
-----WWW-----------------------WWWW-----
-----WWW-----------------------WWWW-----
-----WWW-----------------------WWWW-----
-----WWW-----------------------WWWW-----
-----WWW-----------------------WWWW-----
-----WWW-----------------------WWWW-----
-----WWW-----------------------WWWW-----
-----WWW-----------------------WWWW-----
-----WWW-----------------------WWWW-----
-----WWW-----------------------WWWW-----
-----WWWWWWWWWWWWWWWWWWWWWWWWWWWWWW-----
-----WWWWWWWWWWWWWWWWWWWWWWWWWWWWWW-----
-----WWWWWWWWWWWWWWWWWWWWWWWWWWWWWW-----
----------------------------------------
----------------------------------------
----------------------------------------
----------------------------------------
----------------------------------------