--------------------
--------------------
--------WWWW--------
--------WWWW--------
---WWWWWWWWW--------
---WWWWWWWWW--------
--------WWWW--------
--------WWWWWWWWW---
--------WWWWWWWWW---
--------WWWW--------
---WWWWWWWWW--------
---WWWWWWWWW--------
--------WWWW--------
--------WWWWWWWWW---
--------WWWWWWWWW---
--------WWWW--------
--------WWWW--------
--------WWWW--------
--------------------
--------------------