-----WWWWWWWWWWWWWW---
----WWWWWWWWWWWWWW----
----PPPPPPPPPPPPPP----
----PPPPPPPPPPPPPP----
----PPPPPPPPPPPPPP----
----WWWWWWWWWWWWWW----
----WWWWWWWWWWWWWW----
----------------------
----------------------
----------------------
----------------------
----WWWWWWWWWWWWWW----
----WWWWWWWWWWWWWW----
----PPPPPPPPPPPPPP----
----PPPPPPPPPPPPPP----
----PPPPPPPPPPPPPP----
----WWWWWWWWWWWWWW----
----WWWWWWWWWWWWWW----