--------------------------------------
--------------------------------------
--------------------------------------
--------------------------------------
--------------------------------WWWW--
WWWWWWWWWWWWWWWWWWWWWWWWWWWWWWWWWWWW--
WWWWWWWWWWWWWWWWWWWWWWWWWWWWWWWWWWWW--
WW------------------------------WWWW--
WW------------------------------------
WW------------------------------------
WW----WWWWWWWWWWWWWWWWWWWWWWWWWW------
WW----WWWWWWWWWWWWWWWWWWWWWWWWWW------
WW----WW----------------------WW------
WW----WW----------------------WW------
WW----WW----WWWWWWWWWWWWWW----WW------
WW----WW----WWWWWWWWWWWWWW----WW------
WW----WW----WW----------WW----WW------
WW----WW----WW----------WW----WW------
WW----WW----WW----------WW----WW------
WW----WW----WWWWWWWWPPPPWW----WW------
WW----WW----WWWWWWWWPPPPWW----WW------
WW----WW----------------WW----WW------
WW----WW----------------WW----WW------
WW----WWWWWWWWWWWWWWWWWWWW----WW------
WW----WWWWWWWWWWWWWWWWWWWW----WW------
WW----------------------------WW------
WW----------------------------WW------
WW----------------------------WW------
WWWWWWWWWWWWWWWWWWWWWWWWWWWWWWWW------
WWWWWWWWWWWWWWWWWWWWWWWWWWWWWWWW------
--------------------------------------
--------------------------------------
--WWW---------------------------------
--WWWWWWWWWWWWWWWWWWWWWWWWWWWWWWWWWWWW
--WWWWWWWWWWWWWWWWWWWWWWWWWWWWWWWWWWWW
--WWW---------------------------------
--------------------------------------
--------------------------------------
--------------------------------------
--------------------------------------