WWWWWWWWWW
WWWW--WWWW
----------
----------
----------
----------
----------
----------
----------
----------