----------------------------------------------------------------------------------------------------
----------------------------------------------------------------------------------------------------
--WWWWW--------WW--WW-----WW--WW---------------WW--WW--------------WW--WW-----WW--WW---------WWWWW--
--WWWWWWWWWWWWWWW--WWWWWWWWW--WWWWWWWWWWWWWWWWWWW--WWWWWWWWWWWWWWWWWW--WWWWWWWWW--WWWWWWWWWWWWWWWW--
--WWWWWWWWWWWWWWW--WWWWWWWWW--WWWWWWWWWWWWWWWWWWW--WWWWWWWWWWWWWWWWWW--WWWWWWWWW--WWWWWWWWWWWWWWWW--
--WWWWW--------WW--WW-----WW--WW---------------WW--WW--------------WW--WW-----WW--WW---------WWWWW--
---WWW---------WW--WW-----WW--WW---------------WW--WW--------------WW--WW-----WW--WW----------WWW---
---WWW----------------------------------------------------------------------------------------WWW---
---WWW----------------------------------------------------------------------------------------WWW---
---WWW---------WWWWWW-----WWWWWW---------------WWWWWW--------------WWWWWW-----WWWWWW----------WWW---
---WWW---------WWWWWW-----WWWWWW---------------WWWWWW--------------WWWWWW-----WWWWWW----------WWW---
---WWW----------------------------------------------------------------------------------------WWW---
---WWW----------------------------------------------------------------------------------------WWW---
---WWW----------------------------------------------------------------------------------------WWW---
--WWWWW--WW------------------------------------------------------------------------------WW--WWWWW--
--WWWWW--WW------------------------------------------------------------------------------WW--WWWWW--
---------WW------------------------------------------------------------------------------WW---------
---------WW------------------------------------------------------------------------------WW---------
--WWWWW--WW------------------------------------------------------------------------------WW--WWWWW--
--WWWWW--WW------------------------------------------------------------------------------WW--WWWWW--
---WWW----------------------------------------------------------------------------------------WWW---
---WWW----------------------------------------------------------------------------------------WWW---
---WWW----------------------------------------------------------------------------------------WWW---
---WWW----------------------------------------------------------------------------------------WWW---
---WWW----------------------------------------------------------------------------------------WWW---
---WWW----------------------------------------------------------------------------------------WWW---
---WWW----------------------------------------------------------------------------------------WWW---
---WWW----------------------------------------------------------------------------------------WWW---
---WWW----------------------------------------------------------------------------------------WWW---
---WWW----------------------------------------------------------------------------------------WWW---
--WWWWW--WW---------------WWWWWWW--------------WW--WW--------------WWWWWWW---------------WW--WWWWW--
--WWWWW--WW---------------WWWWWWW--------------WW--WW--------------WWWWWWW---------------WW--WWWWW--
---------WW---------------WWWWWWWWWWWWWWWWWWWWWWW--WWWWWWWW--WWWWWWWWWWWWW---------------WW---------
---------WW---------------WWWWWWWWWWWWWWWWWWWWWWW--WWWWWWWWWWWWWWWWWWWWWWW---------------WW---------
--WWWWW--WW---------------WWWWWWWWWWWWWWWWWWWWWWW--WWWWWWWWWWWWWWWWWWWWWWW---------------WW--WWWWW--
--WWWWW--WW---------------WWWWWWW--------------WW--WW--------------WWWWWWW---------------WW--WWWWW--
---WWW--------------------WWWWWWW--------------WW--WW--------------WWWWWWW--------------------WWW---
---WWW----------------------WWW--------------------------------------WWW----------------------WWW---
---WWW----------------------WWW--------------------------------------WWW----------------------WWW---
---WWW----------------------WWW--------------------------------------WWW----------------------WWW---
---WWW----------------------WWW---------WWWWWWWWWWWWWWWWWWWW---------WWW----------------------WWW---
---WWW----------------------WWW---------WWWWWWWWWWWWWWWWWWWW---------WWW----------------------WWW---
---WWW----------------------WWW---------WWWWWWWWWWWWWWWWWWWW---------WWW----------------------WWW---
---WWW----------------------WWW---------WWWWWWWWWWWWWWWWWWWW---------WWW----------------------WWW---
---WWW----------------------WWW---------WWWWWWWWWWWWWWWWWWWW---------WWW----------------------WWW---
---WWW----------------------WWW---------WWWWWWWWWWWWWWWWWWWW---------WWW----------------------WWW---
---WWW----------------------WWW---------WWWWWWWWWWWWWWWWWWWW---------WWW----------------------WWW---
--WWWWW--WW---------------WWWWWWW-------WWWWWWWPPPPPPWWWWWWW-------WWWWWWW---------------WW--WWWWW--
--WWWWW--WW---------------WWWWWWW-------WWWWWWWPPPPPPWWWWWWW-------WWWWWWW---------------WW--WWWWW--
---------WW-----------------------------WWWWWWW------WWWWWWW-----------------------------WW---------
---------WW-----------------------------WWWWWWW------WWWWWWW-----------------------------WW---------
--WWWWW--WW---------------WWWWWWW-------WWWWW----------WWWWW-------WWWWWWW---------------WW--WWWWW--
--WWWWW--WW---------------WWWWWWW-------WWWWW----------WWWWW-------WWWWWWW---------------WW--WWWWW--
---WWW----------------------WWW---------WWWWW----------WWWWW---------WWW----------------------WWW---
---WWW----------------------WWW--------------------------------------WWW----------------------WWW---
---WWW----------------------WWW--------------------------------------WWW----------------------WWW---
---WWW----------------------WWW--------------------------------------WWW----------------------WWW---
---WWW----------------------WWW---------WWWWW----------WWWWW---------WWW----------------------WWW---
---WWW----------------------WWW---------WWWWW----------WWWWW---------WWW----------------------WWW---
---WWW----------------------WWW---------WWWWW----------WWWWW---------WWW----------------------WWW---
---WWW----------------------WWW---------WWWWW----------WWWWW---------WWW----------------------WWW---
---WWW----------------------WWW--------------------------------------WWW----------------------WWW---
---WWW----------------------WWW--------------------------------------WWW----------------------WWW---
---WWW--------------------WWWWWWW--------------WW--WW--------------WWWWWWW--------------------WWW---
--WWWWW--WW---------------WWWWWWW--------------WW--WW--------------WWWWWWW---------------WW--WWWWW--
--WWWWW--WW---------------WWWWWWWWWWWWWWWWWWWWWWW--WWWWWWWWWWWWWWWWWWWWWWW---------------WW--WWWWW--
---------WW---------------WWWWWWWWWWWWWWWWWWWWWWW--WWWWWWWWWWWWWWWWWWWWWWW---------------WW---------
---------WW---------------WWWWWWWWWWWWWWWWWWWWWWW--WWWWWWWWWWWWWWWWWWWWWWW---------------WW---------
--WWWWW--WW---------------WWWWWWW--------------WW--WW--------------WWWWWWW---------------WW--WWWWW--
--WWWWW--WW---------------WWWWWWW--------------WW--WW--------------WWWWWWW---------------WW--WWWWW--
---WWW----------------------------------------------------------------------------------------WWW---
---WWW----------------------------------------------------------------------------------------WWW---
---WWW----------------------------------------------------------------------------------------WWW---
---WWW----------------------------------------------------------------------------------------WWW---
---WWW----------------------------------------------------------------------------------------WWW---
---WWW----------------------------------------------------------------------------------------WWW---
---WWW----------------------------------------------------------------------------------------WWW---
---WWW----------------------------------------------------------------------------------------WWW---
---WWW----------------------------------------------------------------------------------------WWW---
---WWW----------------------------------------------------------------------------------------WWW---
--WWWWW--WW------------------------------------------------------------------------------WW--WWWWW--
--WWWWW--WW------------------------------------------------------------------------------WW--WWWWW--
---------WW------------------------------------------------------------------------------WW---------
---------WW------------------------------------------------------------------------------WW---------
--WWWWW--WW------------------------------------------------------------------------------WW--WWWWW--
--WWWWW--WW------------------------------------------------------------------------------WW--WWWWW--
---WWW----------------------------------------------------------------------------------------WWW---
---WWW----------------------------------------------------------------------------------------WWW---
---WWW----------------------------------------------------------------------------------------WWW---
---WWW---------WWWWWW-----WWWWWW---------------WWWWWW--------------WWWWWW-----WWWWWW----------WWW---
---WWW---------WWWWWW-----WWWWWW---------------WWWWWW--------------WWWWWW-----WWWWWW----------WWW---
---WWW----------------------------------------------------------------------------------------WWW---
---WWW----------------------------------------------------------------------------------------WWW---
---WWW---------WW--WW-----WW--WW---------------WW--WW--------------WW--WW-----WW--WW----------WWW---
--WWWWW--------WW--WW-----WW--WW---------------WW--WW--------------WW--WW-----WW--WW---------WWWWW--
--WWWWWWWWWWWWWWW--WWWWWWWWW--WWWWWWWWWWWWWWWWWWW--WWWWWWWWWWWWWWWWWW--WWWWWWWWW--WWWWWWWWWWWWWWWW--
--WWWWWWWWWWWWWWW--WWWWWWWWW--WWWWWWWWWWWWWWWWWWW--WWWWWWWWWWWWWWWWWW--WWWWWWWWW--WWWWWWWWWWWWWWWW--
--WWWWW--------WW--WW-----WW--WW---------------WW--WW--------------WW--WW-----WW--WW---------WWWWW--
----------------------------------------------------------------------------------------------------
----------------------------------------------------------------------------------------------------