WWWWWWWWWWWWWWWWWWWWWWWWWWWWWWWWWWWWWW
WWWWWWWWWWWWWW--WWWWWWWWWWWWWWWWWWWWWW
PP----PPPP----------------PPPP----PPWW
PP----PPPP----------------PPPP----PPWW
PP----PPPP----------------PPPP----PPWW
PP----PPPP----------------PPPP----PPWW
PPPPPPPPPPPPPPPPPPPPPPPPPPPPPPPPPPPPWW
PPPPPPPPPPPPPPPPPPPPPPPPPPPPPPPPPPPPWW
------------------------------------WW
------------------------------------WW
--------------------------------------
--------------------------------------
--------------------------------------
--------------------------------------
------------------------------------WW
------------------------------------WW
PPPPPPPPPPPPPPPPPPPPPPPPPPPPPPPPPPPPWW
PPPPPPPPPPPPPPPPPPPPPPPPPPPPPPPPPPPPWW
PP----PPPP----------------PPPP----PPWW
PP----PPPP----------------PPPP----PPWW
PP----PPPP----------------PPPP----PPWW
PP----PPPP----------------PPPP----PPWW