--------------------
--------------------
--------------------
--------------------
--WWWWWWWWWWWWWWWW--
--WWWWWWWWWWWWWWWW--
--WW------------WW--
--WW------------WW--
--WW------------WW--
--WW------------WW--
--WWWWWWW--WWWWWWW--
--WWWWWWW--WWWWWWW--
--WW------------WW--
--WW------------WW--
--WW------------WW--
--WW------------WW--
--WWWWWWW--WWWWWWW--
--WWWWWWW--WWWWWWW--
--WW------------WW--
--WW------------WW--
--WW------------WW--
--WW------------WW--
--WW------------WW--
--WW------------WW--
--WW------------WW--
--WW------------WW--
--WW------------WW--
--WW------------WW--
--WWWWWWW--WWWWWWW--
--WWWWWWW--WWWWWWW--
--WWWWWWW--WWWWWWW--
--WW------------WW--
--WW------------WW--
--WW------------WW--
--WW------------WW--
--WWWWWWW--WWWWWWW--
--WWWWWWW--WWWWWWW--
--WWWWWWW--WWWWWWW--
--WW------------WW--
--WW------------WW--
--WW------------WW--
--WWWWWWW--WWWWWWW--
--WWWWWWW--WWWWWWW--
--WW------------WW--
--WW------------WW--
--WW------------WW--
--WW------------WW--
--WW------------WW--
--WW------------WW--
--WW------------WW--
--WW------------WW--
--WWWWWWW--WWWWWWW--
--WWWWWWW--WWWWWWW--
--WWWWWWW--WWWWWWW--
--WWWWWWW--WWWWWWW--
--WWWWWWW--WWWWWWW--
--WWWWWWW--WWWWWWW--
--WWWWWWW--WWWWWWW--
--WWWWWWW--WWWWWWW--
--WWWWWWW--WWWWWWW--
--------------------
--------------------
--------------------
--------------------