WWWWWWWW
WWWWWWWW
W------W
W------W
W------W
W------W
--------
--------
--------
--------
--------
--------