----WWWWWWWW----
----WWW--WWW----
----------------
----------------
---WWW----WWW---
---WWW----WWW---
---WWW----WWW---
----------------
----------------
----------------
----------------
----------------
----------------
---WWW----WWW---
---WWW----WWW---
---WWW----WWW---
----------------
----------------