WWWWWWWWWWWWWWWW
WWWWWWWWWWWWWWWW
W------WWWWWWWWW
W------WWWWWWWWW
W------WWWWWWWWW
W------WWWWWWWWW
--------WWWWWWWW
--------WWWW--WW
----------------
----------------
--------WWWWWWWW
--------WWWWWWWW