--------WWWWW--WWW
--------WWWWW--WWW
--------WWWWW--WWW
--------WW--------
--------WW--------
PPPPPPPPWWPPPPPPPP
PPPPPPPPWWPPPPPPPP
PPPPPPPPWWPPPPPPPP
PPPPPPPPWWPPPPPPPP
PPPPPPPPWWPPPPPPPP
PPPPPPPPWWPPPPPPPP
PPPPPPPPWWPPPPPPPP
PPPPPPPPWWPPPPPPPP
PPPPPPPPWWPPPPPPPP
PPPPPPPPWWPPPPPPPP
PPPPPPPPWWPPPPPPPP
PPPPPPPPWWPPPPPPPP
PPPPPPPPWWPPPPPPPP
PPPPPPPPWWPPPPPPPP
PPPPPPPPWWPPPPPPPP
PPPPPPPPWWPPPPPPPP
PPPPPPPPWWPPPPPPPP
PPPPPPPPWWPPPPPPPP
PPPPPPPPWWPPPPPPPP
PP----PPWWPP----PP
PP----PPWWPP----PP
WWW--WWWWWWWW--WWW
WWW--WWWWWWWW--WWW
WWW--WWWWWWWW--WWW
WWW--WWWWWWWW--WWW
------------------
------------------
------------------
------------------