--------------------
--------------------
--------------------
--------------------
--------------------
--------------------
------WWW--WWW------
------WWWWWWWW------
------WWWWWWWW------
--------PPPP--------
--------PPPP--------
------WWWWWWWW------
------WWWWWWWW------
------WWW--WWW------
--------------------
--------------------
--------------------
--------------------
--------------------
--------------------