WWWWWWWWWWWW------WWWWWWWWWWWW
WWWWWWWWWWWW------WWWWWWWWWWWW
WWPPPPPPPPPPPPPPPPPPPPPPPPPPWW
WWPPPPPPPPPPPPPPPPPPPPPPPPPPWW
WWPPPPPPPPPPPPPPPPPPPPPPPPPPWW
WWPPPPPPPPPPPPPPPPPPPPPPPPPPWW
WWPPPPPPPPPPPPPPPPPPPPPPPPPPWW
WWPPPPPWWWWWWWWWWWWWWWWPPPPPWW
WWPPPPPWWWWWWWWWWWWWWWWPPPPPWW
WWPPPPPWPPPPPPPPPPPPPPWPPPPPWW
WWPPPPPWPPPPPPPPPPPPPPWPPPPPWW
WWPPPPPWPPPPPPPPPPPPPPWPPPPPWW
--PPPPPWPPPPPPPPPPPPPPWPPPPP--
--PPPPPWPPPPPPPPPPPPPPWPPPPP--
--PPPPPWPPPPPPPPPPPPPPWPPPPP--
--PPPPPWPPPPPPPPPPPPPPWPPPPP--
WWPPPPPWPPPPPPPPPPPPPPWPPPPPWW
WWPPPPPWPPPPPPPPPPPPPPWPPPPPWW
WWPPPPPWPPPPPPPPPPPPPPWPPPPPWW
WWPPPPPWPPPPPPPPPPPPPPWPPPPPWW
WWPPPPPWPPPPPPPPPPPPPPWPPPPPWW
WWPPPPPWPPPPPPPPPPPPPPWPPPPPWW
WWPPPPPWWWWWWWWWWWWWWWWPPPPPWW
WWPPPPPWWWWWWWWWWWWWWWWPPPPPWW
WWPPPPPPPPPPP----PPPPPPPPPPPWW
WWPPPPPPPPPPP----PPPPPPPPPPPWW
WWPPPPPPPPPPPPPPPPPPPPPPPPPPWW
WWPPPPPPPPPPPPPPPPPPPPPPPPPPWW
WWWWWWWWWWWW------WWWWWWWWWWWW
WWWWWWWWWWWW------WWWWWWWWWWWW