WWWWWWWW
WPPPPPPW
W--WW--W
W--WW--W
W--WW--W
W--WW--W
WPPPPPPW
WWWWWWWW